{
  "maze": [
    ["#", "#", "S", "#", "#", "#", "#"],
    ["#", "T", "G", " ", "B", "G", "#"],
    ["#", "#", "#", "#", "#", "G", "#"],
    ["#", "G", "#", "G", "T", "G", "#"],
    ["E", "T", "#", " ", "#", "G", "#"],
    ["#", " ", "G", " ", "#", "G", "#"],
    ["#", "#", "#", "#", "#", "#", "#"]
  ],
  "B": [10, 5, 3, 6],
  "PlayerSkills": [[10, 3, 9], [5, 2, 5], [3, 1, 4]]
}
