{
  "maze": [
    ["#", "#", "#", "#", "#", "#", "#"],
    ["#", "G", "#", "T", "G", "B", "#"],
    ["#", "G", "#", " ", "#", "#", "#"],
    ["#", "T", "G", "G", "#", "G", "#"],
    ["#", "T", "#", "G", "#", " ", "S"],
    ["#", "G", "#", " ", " ", "G", "#"],
    ["#", "E", "#", "#", "#", "#", "#"]
  ],
  "B": [10, 5, 3, 6],
  "PlayerSkills": [[10, 3, 9], [5, 2, 5], [3, 1, 4]]
}
