{
  "maze": [
    ["#", "#", "#", "S", "#", "#", "#"],
    ["#", "G", "G", "G", "G", " ", "#"],
    ["#", "G", "#", "#", "#", " ", "#"],
    ["#", "T", "G", "G", "#", "G", "#"],
    ["#", "#", "#", " ", "#", "T", "#"],
    ["#", " ", "B", "G", "#", "T", "#"],
    ["#", "#", "#", "E", "#", "#", "#"]
  ],
  "B": [10, 5, 3, 6],
  "PlayerSkills": [[10, 3, 9], [5, 2, 5], [3, 1, 4]]
}
