{
  "maze": [
    ["#","#","#","#","#","#","#","#","#","#","#","#","#","#","#"],
    ["#"," "," "," ","#"," "," "," ","#"," ","T"," ","#"," ","S"],
    ["#"," ","#"," ","#","#","#"," ","#","#","#"," ","#"," ","#"],
    ["#"," ","#"," ","G"," "," "," ","#"," "," "," "," "," ","#"],
    ["#"," ","#","#","#","#","#"," ","#"," ","#"," ","#"," ","#"],
    ["#"," ","#"," "," "," ","#"," ","#"," ","#"," ","#"," ","#"],
    ["#"," ","#"," ","#","G","#"," ","#"," ","#","#","#"," ","#"],
    ["#"," ","#"," ","#"," "," "," "," "," "," "," ","#"," ","#"],
    ["#","#","#","#","#","#","#","#","#"," ","#","#","#","#","#"],
    ["#"," ","#"," "," "," "," "," ","#"," "," "," ","T"," ","#"],
    ["#"," ","#"," ","#","#","#"," ","#"," ","#","#","#"," ","#"],
    ["#"," ","#"," "," ","B","#"," ","#"," "," "," ","#"," ","#"],
    ["#"," ","#"," ","#"," ","#"," ","#"," ","#"," ","#"," ","#"],
    ["#"," ","G","T","#"," ","#"," "," "," ","#"," ","#"," ","#"],
    ["#","#","#","#","#","E","#","#","#","#","#","#","#","#","#"]
  ],
  "B": [50, 60, 55],
  "PlayerSkills": [
    [22, 1, 2],
    [12, 0, 0],
    [32, 2, 5],
    [18, 0, 1],
    [26, 3, 4]
  ]
}